##############
#.#.....#.#..#
#.#..###....##
#.##.##...@..#
#....#..#....#
###....##...##
####.#########
...#.#
..##.#.####
.##..###..#
##........#
#......#..#
###..###..#
..#..#......
.##.##.#.##
.#......##
.#.....##
.###.###